Aha	代名詞	それら	三人称複数主格．人物を指す
Ahw	代名詞	そこ	三人称複数主格．人物以外を指す
Ao/	感動詞	ああ
arma	名詞	牙
arsic	名詞	傷痕
balie	形容詞	沢山の
bediws	名詞	悲しみ
bie	冠詞	その	英語のthe
bis	冠詞	この
bloz	動詞	降る
bran	形容詞	雄々しい
carla	名詞	血
cera	動詞	祝福する
chein	形容詞	左の
ciel	名詞	彼方
cielis	形容詞	彼方の
clar	動詞	歌う
clar	名詞	歌
clar	名詞	約束
co	動詞	息吹く
colin	形容詞	安らかな
cornis	形容詞	始まりの
cross	動詞	帰る
d-	助詞	し続ける
dackt	動詞	潰える
De	助動詞	命令
Dea	感動詞	ほら
delis	動詞	忘れる
delis	感動詞	きっと
Deris	接続詞	だから	英語のbecause
dess	動詞	隠れる
dewl	助動詞	～する必要がある	英語のhave to
-di-	副詞	名詞の接続
dia	動詞	歩く
dim	動詞	笑う
E	代名詞	あなた	二人称主格
Ec	代名詞	あなたの	二人称所有格
ecta	動詞	舞う
edel	動詞	沁みる
Eeo	代名詞	あなたたちを	二人称複数目的格
eis	形容詞	あの
egic	名詞	底
Egunis	名詞	隙間
elah	名詞	～する者
ele	動詞	存在する
elen	名詞	心
elenis	形容詞	心の
elfa	形容詞	懐かしい
elmei	形容詞	全ての
elvine	形容詞	素敵な
ema	動詞	生きる
emne	動詞	委ねる
Eo	代名詞	あなたを	二人称単数目的格
Es	代名詞	あなたたちを	二人称複数目的格
et	助動詞	過去
evhe	名詞	旋律
eyen	前置詞	～のような	英語のlike
Ez	代名詞	あなた	二人称主格
fary	副詞	とても
fel	前置詞	～から	英語のfrom
ferm	名詞	どこか
fert	代名詞	関係代名詞	英語のwhich
flan	形容詞	冷たい
Ful	形容詞	赤の
getie	形容詞	小さな
gillim	動詞	結ぶ
gillim	動詞	一つにする
geen	名詞	季節
gridis	形容詞	誇り高い
harp	動詞	もたらす
haul	動詞	灯す
hec	動詞	否定する
hem	動詞	触れる
hiz	冠詞その	英語のthe
huda	名詞	泉
hypn	動詞	眠る
hypne	名詞	ゆりかご
iden	形容詞	記憶の
iden	動詞	沈む
Ies	名詞	色
Iesis	名詞	色の
iflis	動詞	実がなる
iflis	名詞	優しさ
ilmei	形容詞	大いなる
ilmei	形容詞	大きな
imd	名詞	背中
io	名詞	吐息
Is	動詞	巡る
isel	動詞	書き記す
Isis	形容詞	続いている
Ivis	形容詞	黄昏の
kamis	形容詞	記憶の
kamyu	名詞	記憶
kaon	名詞	牢獄
keen	形容詞	鋭い
kei	名詞	雫
kills	形容詞	氷の
kills	動詞	凍る
kis	動詞	～である	主語が三人称の場合．英語でいうbe動詞
kissin	副詞	時に
kyel	前置詞	～へ
KyelS	名詞	福音
lah	形容詞	もう一つの
Laspha	名詞	主
laphia	名詞	丘
lash	名詞	飛沫
lass	動詞	過ぎる
left	名詞	一瞬
lement	名詞	欠片
leide	名詞	花
lihit	名詞	望み
lihit	動詞	望む
linsy	副詞	そっと
lish	名詞	奇跡
lishe	名詞	愛
lotas	形容詞	切ない
lu	動詞	結ぶ
lube	名詞	声
lue	名詞	音
madel	動詞	断つ
meh	形容詞	一つの
mehnes	感動詞	いま一度
metis	動詞	知らせる
metis	動詞	伝える
metis	動詞	教える
miel	動詞	注ぐ
mixe	動詞	嫌う
meli	名詞	抱擁
mille	動詞	生まれる
milves	形容詞	鏡の
miqis	形容詞	今の
Miqs	副詞	今は
missin	副詞	遥かに
missis	形容詞	果てなき
mutis	形容詞	まばゆい
myizis	形容詞	理想の
nalis	代名詞	関係代名詞	英語のwhich
nazal	名詞	味
nazalie	形容詞	罪色の
nazyu	動詞	枯れる
nec	副詞	否定
nefit	接続詞	たとえ～しても
neights	形容詞	夜明けの
nelar	副詞	ここに	英語のhere
nemne	動詞	～に～を与える
neoles	形容詞	夢見る
nepies	形容詞	憩いの
nes	動詞	～である	主語が二人称の場合．英語でいうbe動詞
nett	名詞	詠
nevaliss	接続詞	だけど	英語のbut
noe	名詞	昔
noi	前置詞	～の中で	英語のin
nuel	名詞	中
nuel	名詞	内
ole	名詞	夢
oles	動詞	夢見る
olte	名詞	真極
omnia	動詞	変える
omnis	動詞	変わる
Oo/	感動詞	ああ
pel	名詞	鈴
pelma	動詞	～に～を与える
pelma	動詞	落ちる
pelnis	形容詞	仮初めの
peq	前置詞	～と一緒に	英語のwith
peqqy	副詞	共に
peqxe	前置詞	～を伴わず	英語のwithout
pha	代名詞	関係代名詞	英語のwhat
pheno	名詞	名前
pheno	名詞	子供
phes	名詞	温もり
phi	名詞	人
phia	名詞	世界
phia	名詞	場所
phia	動詞	描く
phias	名詞	必然
phio	動詞	立ち上がる
Phio	名詞	(セラの)塔
pile	動詞	落とす
qhaon	名詞	翼
r-	助動詞	受動
raqis	形容詞	苔むした
recrey	動詞	映る
reh	形容詞	両方の
rei	名詞	雨
rein	動詞	夢を見る
ria	前置詞	～のために	英語のfor
rien	動詞	鳴る
Rio	代名詞	私たちを	一人称目的格
riris	名詞	約束
ririsis	形容詞	約束の
riss	前置詞	～と共に	英語のwith
roo	形容詞	(心情的に)遥かな
roos	形容詞	(物理的に)遠い
ruy	名詞	上
Se	接続詞	だから	英語のso
Sec	代名詞	私の	一人称所有格
Selahphenosias	名詞	セラフェノ真言
Sera	接続詞	だから	英語のso
Ses	代名詞	私に	一人称目的格
Sew	代名詞	私	一人称主格
shadilis	形容詞	黎い
shadilis	形容詞	暗い
shamis	形容詞	煌めく
shan	名詞	瞬き
shantis	形容詞	煌めく
shaz	名詞	紡ぎ
shela	動詞	願う
shen	名詞	願い
sheon	名詞	鐘
sink	動詞	濡らす
siole	形容詞	真の
sion	動詞	渇望する
slin	動詞	旅立つ
soa	動詞	響く
solia	動詞	渇かせる
solit	名詞	孤独
solitis	形容詞	孤独な
sophia	動詞	会う
soul	形容詞	孤独な
sraghch	名詞	龍
steras	形容詞	数多の
stery	副詞	千々に
steris	形容詞	砕けた
Te	助動詞	命令	虹色名詠のみ
tes	副詞	～と	英語のand
tiein	形容詞	右の
tih	形容詞	多くの
tih	形容詞	七色の
Tihs	形容詞	第七の
tinny	名詞	時間
tinny	名詞	物語
tis	名詞	道
towle	形容詞	儚い
tyma	動詞	叶う
uc	前置詞	～によって	英語のby
Uhw	代名詞	それ	三人称単数主格
Uhz	代名詞	それ	三人称単数主格
Ulma	感動詞	さあ
valen	名詞	祈り
van	前置詞	～だけ	英語のonly
veci	名詞	守る
vecisia	名詞	真言の守護者
veiz	名詞	爪
vel	助動詞	不定詞or動名詞
veqlem	名詞	蛇
vequs	動詞	縛る
vi-	前置詞	直後の名詞を不定形にする	vi-phiaで「どこか」
vilis	動詞	知る
vilis	動詞	知っている
virse	名詞	詩
warbis	形容詞	ゆらめく
was	代名詞	関係副詞	英語のwhere
was	前置詞	～へ	英語のto
wat	前置詞	～の上を	英語のon
wi	感動詞	さあ
wire	名詞	筐
wiz	名詞	姿
xearc	形容詞	透き通った
xedelis	動詞	思い出す
xedolis	動詞	必要とする
xeines	副詞	素足で
xeo	名詞	夜
xeph	動詞	起きる
xephias	名詞	偶然
xin	名詞	未来
xiss	動詞	聞く
xixic	名詞	ささやき
yahe	名詞	言葉
-Ye-	副詞	名詞を接続する
yehle	動詞	結ぶ
ymy	名詞	口づけ
yuks	名詞	調べ
yulis	動詞	忘れる
yulis	動詞	消える
yu	前置詞	～に	英語のfor
yubel	動詞	許す
yum	動詞	沈む
yum	動詞	消える
yum	助動詞	きっと～する	英語のwill？
yuma	名詞	優しさ
yumie	形容詞	優しい
yupa	副詞	もはや
yuty	形容詞	心踊るような
zarabel	名詞	涙
zayxus	副詞	永劫に
zea	名詞	樹
Zerah	名詞	母
Zerah	名詞	福音
zsary	動詞	泣く